# FnRn:NESW

f0r0
.'--d--'*
:/     \;
|       |
|       |
d       d
|       |
|       |
:*     .;
\"--d--"/

f0r1
.'--d--'*
:/     \;
|       |
|       |
d  ---  d
|       |
|       |
:*     .;
\"--d--"/

f0r2
.'--d--'*
:/     \;
|       |
|   |   |
d   |   d
|   |   |
|       |
:*     .;
\"--d--"/

f0r3
.'--d--'*
:/     \;
|   |   |
|   |   |
d --+-- d
|   |   |
|   |   |
:*     .;
\"--d--"/